あせ	(；・∀・)	顔文字	
あーあー	(∩ﾟдﾟ)ｱｰｱｰきこえなーい	顔文字	
あせ	（；^ω^）	顔文字	
あつい	ι(´Д｀υ)ｱﾂｨｰ	顔文字	
あったかーい	(*´∀｀*)ｱｯﾀｶｰｲ	顔文字	
あっちいけ	ｱｯﾁ(・∀・)ｲｹ!!	顔文字	
あはは	ｧ '`,､'`,､('∀`) '`,､'`,､	顔文字	
あはは	( ﾟ∀ﾟ)ｱﾊﾊ八八ﾉヽﾉヽﾉヽﾉ ＼ / ＼/ ＼	顔文字	
あひゃ	(ﾟ∀ﾟ)ｱﾋｬ	顔文字	
あひゃ	ﾍ(ﾟ∀ﾟﾍ)ｱﾋｬ	顔文字	
あひゃ	(゜∀。)ﾜﾋｬﾋｬﾋｬﾋｬﾋｬﾋｬ	顔文字	
あぶねー	 ｱﾌﾞﾈ━━━━Σ(ﾟдﾟ；)━━━━!!	顔文字	
あらま	Σ(ﾟДﾟ；)ｱﾗﾏｯ	顔文字	
あらまあ	(´・∀・｀ )ｱﾗﾏｧ	顔文字	
ありがとう	あ(・∀・)り(・∀・)が(・∀・)と(・∀・)う！	顔文字	
ありゃ	Σ(ﾟДﾟ υ) ｱﾘｬ	顔文字	
いい	(・∀・)ｲｲ!!	顔文字	
いい	(　・∀・)ｲｲ!!	顔文字	
いいね	(・∀・)ｲｲﾈ!!	顔文字	
いえーい	☆-(ノﾟДﾟ)八(ﾟДﾟ　)ノｲｴｰｲ	顔文字	
いえーい	ｲｪ━━━━━ヽ( ﾟДﾟ)人(ﾟДﾟ )ﾉ━━━━━━ｲ!!	顔文字	
いえーい	(｀・∀・)ﾉｲｪ-ｲ！	顔文字	
いえーい	ｲｴ━━٩(*´ᗜ`)ㅅ(ˊᗜˋ*)و━━ｲ	顔文字	
いかす	Σd(ﾟ∀ﾟd)ｲｶｽ!	顔文字	
いかり	(#･∀･)	顔文字	
いかり	(# ﾟДﾟ)	顔文字	
いかり	（#^ω^）	顔文字	
いぎあり	( ﾟДﾟ)_σ異議あり!!	顔文字	
いきろ	つωT｀)ヾ (ﾟДﾟ )…ｲ㌔	顔文字	
いくない	(・A・)ｲｸﾅｲ!!	顔文字	
いた	ｲﾀ━━━━(ﾟ∀ﾟ)━━━━!!	顔文字	
いたい	( #)ω･)ｲﾀｲ	顔文字	
いってら	┌( ﾟДﾟ)ﾉ ｲｯﾃﾗｰ	顔文字	
いやぁ	(∀｀*)ゞｲﾔｧ	顔文字	
いやん	(/ω＼)ｲﾔﾝ	顔文字	
いらいら	(#ﾟДﾟ)y-~~ｲﾗｲﾗ	顔文字	
うー	(」・ω・)」うー!	顔文字	
うぇ	ヽ(ﾟ∀｡)ﾉｳｪ	顔文字	
うざー	ｳｻﾞ―(ﾟДﾟ)―ｯ!!	顔文字	
うざー	ｳｻﾞ━━━(´∀｀；)━━━!!!!	顔文字	
うぜー	(　´Α｀)ｳｾﾞｰ	顔文字	
うっ	(´；ω；｀)ｳｯ…	顔文字	
うひょー	( ﾟДﾟ)ｳﾋｮｰ	顔文字	
うふふ	(´∀｀*)ｳﾌﾌ	顔文字	
うまー	(ﾟдﾟ)ｳﾏｰ	顔文字	
うまうま	(ﾟ∀ﾟ)ｳﾏｳﾏ	顔文字	
うむ	(　ﾟдﾟ)ｳﾑ	顔文字	
うわーん	ヽ(`Д´)ﾉｳﾜｧｧｧﾝ!!	顔文字	
うんこ	ヽ( ・∀・)ﾉ ｳﾝｺｰ	顔文字	
えっ	(´･ω｀･)ｴｯ?	顔文字	
えっへん	(｀・∀・´)ｴｯﾍﾝ!!	顔文字	
えへへ	(∀｀*ゞ)ｴﾍﾍ	顔文字	
おいおい	ヾ(ﾟДﾟ )ｫｨｫｨ	顔文字	
おえー	ｵｴ━━━━━━(´Д｀|||)━━━━━━!!!!	顔文字	
おーい	( ｣ﾟДﾟ)｣ｵｰｲ!	顔文字	
おーい	L(・∀・ L) ｵｰｲ　　(」・∀・)」 ｵｰｲ	顔文字	
おかえり	ｵｶヽ(´∀｀ )ﾉｴﾘｰ!!	顔文字	
おちゃ	(・∀・)つ目　ｵﾁｬﾉﾒ!	顔文字	
おつ	(꜆꜄꜆˙꒳˙)꜆꜄꜆ ｵﾂｵﾂｵﾂｵﾂ	顔文字	
おつかれ	(_´Д｀)ﾉ~~ｵﾂｶﾚｰ	顔文字	
おけ	OK(๑•̀ㅂ•́)و✧	顔文字	
おけ	おけ( ¯꒳¯ )ｂ✧	顔文字	
おけ	Σd(･ω･´｡)ок!!	顔文字	
おてあげ	∩(・∀・)∩　ﾓｳ ｵﾃｱｹﾞﾀﾞﾈ	顔文字	
おめでとう	お(・∀・)め(・∀・)で(・∀・)と(・∀・)う！	顔文字	
おやすみ	(つ∀-)ｵﾔｽﾐｰ	顔文字	
がーん	ｶﾞ━━(;ﾟДﾟ)━━ﾝ!!	顔文字	
がーん	Σ(ﾟдﾟlll)ｶﾞｰﾝ	顔文字	
かえれ	(・∀・)ｶｴﾚ!!	顔文字	
かお	( ˙꒳​˙  )	顔文字	
にちゃ	( ◜ᴗ◝)	顔文字	
かお	(・∀・)	顔文字	
かお	(｀・ω・´)	顔文字	
かお	(´・ω・｀)	顔文字	
がくぶる	((((；ﾟДﾟ))))ｶﾞｸｶﾞｸﾌﾞﾙﾌﾞﾙ	顔文字	
かめら	ﾊﾟｼｬｯ! Σp[【◎】]ω･´)	顔文字	
かもーん	щ(ﾟдﾟщ)ｶﾓｰﾝ	顔文字	
かもーん	ｶﾓｫｫｫ━━━━━(屮ﾟДﾟ)屮━━━━━ﾝ!!!!!!	顔文字	
かわいい	ｶﾜ(・∀・)ｲｲ!!	顔文字	
ぎくっ	Σ(ﾟДﾟ；)ｷﾞｸｯ	顔文字	
きたー	ｷﾀ━(ﾟ∀ﾟ)━!	顔文字	
きたー	ｷﾀｷﾀｷﾀｷﾀ━━━(ﾟ∀ﾟ≡(ﾟ∀ﾟ≡ﾟ∀ﾟ)≡ﾟ∀ﾟ)━━━━!!	顔文字	
きたこれ	(ﾟ∀ﾟ)ｷﾀｺﾚ!!	顔文字	
きっく	ヽ( ・∀・)ﾉ┌┛Σ(ノ `Д´)ノ	顔文字	
きも	(　´Д｀)ｷﾓｯ	顔文字	
きゃー	Σ(ﾟ∀ﾟﾉ)ﾉｷｬｰ	顔文字	
きゃっ	ヽ(・∀・ )ﾉ ｷｬｯ ｷｬｯ	顔文字	
きゃっ	ヾ(*´∀｀*)ﾉｷｬｯｷｬ	顔文字	
きょろ	o(ﾟДﾟ = ﾟДﾟ)o ｷｮﾛｷｮﾛ	顔文字	
きりっ	( ｰ`дｰ´)ｷﾘｯ	顔文字	
くしゃみ	(　>д<)､;'.･　ｨｸｼｯ	顔文字	
くちぶえ	♪～(´ε｀　)	顔文字	
くっ	ｸｯ……ﾔﾗ( ﾟ∀ﾟ )ﾚﾀ!!!	顔文字	
ぐで	_(:3 」∠)_	顔文字	
ぐはっ	( ﾟ∀ﾟ)･∵. ｸﾞﾊｯ!!	顔文字	
くるな	ｸﾙﾅ━━━━━━( ﾟДﾟ)┛━━━━━━!!	顔文字	
くれ	(　ﾟдﾟ)ｸﾚ	顔文字	
けいれい	(｀･ω･´)ゞ	顔文字	
けっこん	ｹｺ━━━━(・∀・)人(・∀・)━━━━ﾝ	顔文字	
げっ	Σ(・∀・|||)ｹﾞｯ!!	顔文字	
ごくり	(； ･`д･´)…ｺﾞｸﾘ…(`･д´･ ；)	顔文字	
こそーり	|ﾟДﾟ)))ｺｿｰﾘ!!!!	顔文字	
このやろう	(´・ω・)９　このやろう	顔文字	
ごめん	(m´・ω・｀)m ｺﾞﾒﾝ…	顔文字	
こら	(｀・д・´)ｺﾗ､ﾔﾒﾀﾏｴ!!	顔文字	
こら	(#ﾟДﾟ)ｺﾞﾙｧ!!	顔文字	
こわー	ｺｯ､ｺﾜ━━━━━(((( ；ﾟДﾟ))))━━━━━━ｯ!!!	顔文字	
こわれた	∑(・∀・) ｺﾜﾚﾀ !!	顔文字	
さっ	|彡ｻｯ	顔文字	
ざまぁ	ｻﾞﾏｧ━━━━━━m9(^Д^)9m━━━━━━!!!!!!	顔文字	
さんくす	d(ﾟДﾟ )☆ｽﾍﾟｼｬﾙｻﾝｸｽ☆( ﾟДﾟ)b	顔文字	
じー	(・д・)ｼﾞｰｯ	顔文字	
しつもん	( ﾟдﾟ)ノ　ﾊｲ!ｼﾂﾓｰﾝ!	顔文字	
しょぼーん	(´・ω・｀)ｼｮﾎﾞｰﾝ	顔文字	
さらぁ	ｻﾗｧ...(´・ω:;.:...	顔文字	
しらね	(ﾟ⊿ﾟ)ｼﾗﾈ	顔文字	
しらんがな	(´・ω・`)知らんがな	顔文字	
しんぎちゅう	【審議中】　(　´・ω) (´・ω・) (・ω・｀) (ω・｀ )	顔文字	
すげー	ｽｹﾞ━━━━━━ヽ(ﾟДﾟ)ﾉ━━━━━━!!!!	顔文字	
すげぇ	Σ(ﾟДﾟ)ｽｹﾞｪ!!	顔文字	
それだ	(・∀・)ｿﾚﾀﾞ!!	顔文字	
だいじょうぶ	(；・∀・)ﾀﾞ､ﾀﾞｲｼﾞｮｳﾌﾞ…?	顔文字	
たのむ	(人∀・)ﾀﾉﾑ	顔文字	
たばこ	( ﾟДﾟ)y─┛~~	顔文字	
だまれ	(# ﾟДﾟ)ﾀﾞﾏﾚ!!	顔文字	
ためいき	( ´Д｀)=3	顔文字	
ちっ	(・д・)ﾁｯ	顔文字	
ちゅっ	(´ε｀　)ﾁｭｯ	顔文字	
ちら	| ˙꒳​˙)ﾁﾗﾘﾝﾁｮ	顔文字	
ちら	|ω･)ﾁﾗ	顔文字	
でたー	ﾃﾞﾀ━━━━━━━━m9( ﾟ∀ﾟ)人(ﾟ∀ﾟ )9m━━━━━━━━!!	顔文字	
てれ	(*´ω｀*)	顔文字	
てれ	(*´∀｀*)	顔文字	
なかーま	( ´∀｀)人(´∀｀ )ﾅｶｰﾏ	顔文字	
なかーま	(・∀・)人(・∀・)ﾅｶｰﾏ	顔文字	
なかーま	ヽ(*･ᗜ･)人(･ᗜ･* )ﾉ ﾅｶｰﾏ	顔文字	
なぐる	(ｏﾟДﾟ)＝◯)`3゜)∵	顔文字	
なく	( ；∀；)	顔文字	
なく	(´；ω；｀)	顔文字	
なんだってー	(； ･`д･´) ﾅ､ﾅﾝﾀﾞｯﾃｰ!! (`･д´･ ；)	顔文字	
なんだと	( ･`ω･´)ﾅﾝ…ﾀﾞﾄ!?	顔文字	
にゃー	(/・ω・)/にゃー!	顔文字	
にやにや	（・∀・）ﾆﾔﾆﾔ	顔文字	
ねー	(*´･ω･)(･ω･｀*)ﾈｰ	顔文字	
ねむい	(´ぅω・｀)ﾈﾑｲ	顔文字	
はぁ	( ﾟДﾟ)ﾊｧ?	顔文字	
ぱぁ	( ᐛ👐) パァ	顔文字	
はぅ	(´д⊂)‥ﾊｩ	顔文字	
ぱくっ	(｡・н・｡)ﾊﾟｸｯ	顔文字	
はずかし	(/ω＼)ﾊｼﾞｭｶｼ…	顔文字	
はっ	( ﾟдﾟ)ﾊｯ!	顔文字	
ばんざい	∩( ・ω・)∩　ばんじゃーい	顔文字	
ぱんち	○（#ﾟДﾟ）=（　 #）≡○)Д`)･∴'.	顔文字	
ぱんち	c(`･ω´･ c)っ≡つ ﾊﾞﾊﾞﾊﾞﾊﾞ	顔文字	
はよ	はよ(ﾉｼ 'ω')ﾉｼ ﾊﾞﾝﾊﾞﾝ	顔文字	
ばんばん	(ﾉｼ 'ω')ﾉｼ ﾊﾞﾝﾊﾞﾝ	顔文字	
びきびき	（#^ω^）ﾋﾞｷﾋﾞｷ	顔文字	
ひどいよ	（#)Д`;;）…ﾋﾄﾞｲﾖ…	顔文字	
ふふふ	(ΦωΦ)ﾌﾌﾌ…	顔文字	
ふむふむ	φ(ﾟДﾟ )ﾌﾑﾌﾑ…	顔文字	
へー	(´・∀・｀)ﾍｰ	顔文字	
ぺっ	(　ﾟдﾟ)､ﾍﾟｯ	顔文字	
ぽいっ	・⌒ヾ( ﾟ⊿ﾟ)ﾎﾟｲｯ	顔文字	
ほう	( ﾟдﾟ)ﾎｩ	顔文字	
ぽかーん	(　ﾟдﾟ)ﾎﾟｶｰﾝ	顔文字	
ほしい	(　ﾟдﾟ)ﾎｽｨ…	顔文字	
ほっ	ε-(´∀｀*)ﾎｯ	顔文字	
まじれす	ﾈﾀﾆﾏｼﾞﾚｽ(・∀・)ｶｺﾜﾙｲ!!	顔文字	
むすっ	( ｰ̀ н ｰ́ )ﾑｽｯ	顔文字	
かお	( ･`д･´)	顔文字	
まがお	(￣・ω・￣)	顔文字	
もぐもぐ	(´～｀)ﾓｸﾞﾓｸﾞ	顔文字	
やったー	ᐠ( ᐛ )ᐟﾔｯﾀｱｱｱｱｱｱｱｱｱｱｱｱ	顔文字	
やられた	ｸｯ……ﾔﾗ( ﾟ∀ﾟ )ﾚﾀ!!!	顔文字	
よろしく	( ｀・∀・´)ﾉﾖﾛｼｸ	顔文字	
わお	ヮ(ﾟдﾟ)ォ!	顔文字	
わけわからん	⊂( ・∀・)ﾜｹ ( ・∀・)つﾜｶ ⊂( ・∀・)つﾗﾝ♪	顔文字	
わっしょい	ﾜｯｼｮｲヽ(ﾟ∀ﾟ)メ(ﾟ∀ﾟ)メ(ﾟ∀ﾟ)ノﾜｯｼｮｲ	顔文字	
